50 50 10 win 1.5 1.5
22111111111111111111113111111111111311111111111111
20000000000000000000000000000000000000000000000003
10513111110111111114113111101111111114111111141111
10100000000100000000000000000000000000000000000001
10101111111101111101111111111111111111111311111101
10101000100101010004000000100000000000000000000001
10100010000100010111011110101311111111111411111101
10111111111141010100010000100000001000000000000001
10000000000000010101110111101111011011111111111101
10111111111113110001000100001000010010000000000001
10000000000000011111011101111111110110111111111111
30111101111111000000010001000000000100100010000001
10100001010001111111110131011111111101110000001001
10101100000100010000000100010000000000011111111101
10001001111110101131111141110111111111000000000001
13111111000000001000000001000100010001111011131111
10000000011114111013110101011101000100001000000001
10111113110000001010000101010001111111101111101111
10100000000111101010000101010000000000100000100001
10101310111100001011141101011141111110111110111101
10001000100110001000001001000000100010000010000001
11101011100001101111101011113110101010000011111001
10001000111100100000101000000010101011111000001001
10111110000110111110101111111010101000001111101111
10100010000010000010100000001010101111100000100001
10111011111011111010111111101010100000111110111101
10001000001000001010000000101010111110000010000001
10101141101111001011113110101010000031111011111111
10100000100001001000000010101011111000001000000001
10131010111101001111111010101000001111101111111101
10001010000101000000001010101111100000100000000001
11101011100101111111101010100000111110111113113111
10001000100100000000101010111110000010001000000001
10111110100111111110101010000011111011101014110001
10100000100000000010101011111000001000101000010001
10001011111411111010101000001111101110101141011111
11131010000000001010101141100000100010100001000001
10000011111111101000100000111110111010111101111101
10101000000000101131141110100010001010000100000001
10311141131110101000000010101011101011110114111111
10100000100010101011111010101000101000010000000001
10001110101010101000001010101110101111011311111101
10111000101110101111101010100010100001000000000001
10101001100100100000101010111010111101111411111111
10101101110103111110101010000010000100000000000001
10100100000100000000101011111311110111111411111101
10110114111114111110001000000000010000000000000001
10100000110001100011111111111114111111311111411111
10001310000100001000000000000000000000000000000005
11311111111111111111111111111131111111311111311111
1 1 1
30 8 1
50 2 1
29 28 1
23 23 1
16 14 1
5 13 1
22 18 1
23 12 1
42 4 1
